Selbstzweifel haben	nie wierzyæ we w³asne mo¿liwoœci 
e Tinte	atrament 
fokussieren	ogniskowaæ, koncentrowaæ 
r Ast, ä-e	konar (+ Pl.)
e Erörterung	rozprawa 
von Liebe erfüllt sein	byæ przepe³nionym mi³oœci¹ 
aus-sterben	wymieraæ, wygin¹æ 
r Pol, -y	biegun (geogr.) (+ Pl.)
e Wirkung	efekt, dzia³anie 
die Vorschriften ein-halten	przestrzegaæ przepisów 
sich drei Tage in Krakau auf-halten	zatrzymaæ siê na 3 dni w Krakowie 
e Bestürzung	konsternacja/przera¿enie 
das Dreifache verdienen	zarabiaæ trzykrotnoœæ poprzedniej pensji 
unmittelbar	bezpoœredni 
Sehnsucht spüren	odczuwaæ têsknotê 
schuldhaftes Verhalten	karygodne zachowanie 
s Vertrauen	zaufanie 
e Zuversicht	ufnoœæ, wiara 
s Unglück, -e	nieszczêœcie (+ Pl.)
zerreißen	drzeæ (papier) 
r Wipfel	wierzcho³ek 
e Nachwuchskräfte	m³ode kadry, narybek 
Der Sturm nimmt zu.	Burza siê wzmaga. 
zustande kommen	dojœæ do skutku 
e Angleichung	dostosowanie 
e Schwimmhaut	b³ona p³awna 
e Bindung	zwi¹zek/zobowi¹zanie 
ähnlich wie bei/in D	podobnie jak w [czymœ] 
sich zum Abschied die Hand schütteln	podaæ sobie rêkê na po¿egnanie 
sorgfältig	staranny 
auf die Homepage verweisen	skierowaæ na stronê internetow¹ 
mild	³agodny (np. klimat) 
r Hürde, -n	p³otek, przeszkoda (+ Pl.)
vorwiegend	przewa¿nie 
schattig	cienisty, zacieniony 
s Laub	listowie 
s Mitleid	wspó³czucie, litoœæ 
e Schwimmflosse	p³etwa (do nurkowania) 
leistungsfähig	sprawny, wydajny 
s Polarlicht	zorza polarna 
