Das ist doch Haarspalterei!	To jest dzielenie włosa na czworo! (przysł.) 
bescheiden/eingebildet	skromny/zarozumiały 
tolerant/intolerant	tolerancyjny/nietolerancyjny 
Er dreht jeden Pfennig dreimal um.	On jest bardzo oszczędny. (przysł.) 
muskulös	muskularny 
lustig/traurig	pocieszny/smutny 
zuverlässig	niezawodny 
vernünftig/unvernünftig	rozsądny/nierozsądny 
gammelig	nieświeży 
fröhlich/traurig	wesoły/smutny 
schmales Gesicht	szczupła twarz 
ordentlich	porządny, solidny (człowiek) 
faltig	pomarszczony 
geschickt/ungeschickt	zreczny/niezręczny 
lieb zu den Kindern	miły dla dzieci 
breitschultrig	barczysty 
zerknittert	pomięty 
interessant/langweilig	interesujący/nudny 
offen/verschlossen	otwarty/skryty 
gut/böse	dobry/zły 
arrogant	arogancki 
gepflegt/ungepflegt	zadbany/zaniedbany 
Er hat das Herz auf dem rechten Fleck.	On jest altruistą. (przysł.) 
eigenartig	specyficzny, osobliwy (człowiek) 
schütteres/dichtes Haar	rzadkie włosy/gęste włosy 
stur wie ein Bock	uparty jak kozioł 
Du bist ja nich auf den Kopf gefallen	Nie jesteś głupi. (przysł.) 
Er lässt nie ein gutes Haar an ihr.	On zawsze ją krytykuje. (przysł.) 
kontaktfreudig/zurückhaltend	towarzyski/powściągliwy 
ernst	poważny 
Aber das ist doch an den Haaren herbeigezogen!	To nie ma żadnego związku z problemem. (przysł.) 
liebenswürdig	uprzejmy 
kräftig	silny 
rundliches Gesicht	okrągła twarz 
korpulent	korpulentny 
