im Widerspruch stehen zu D	byæ w sprzecznoœci z [czymœ]
unter Anklage stehen	byæ oskar¿onym
etw auf Eis legen	zawieszaæ coœ
zu Ende bringen	zakoñczyæ
in Haft nehmen	aresztowaæ
in Anspruch nehmen	wymagaæ, ¿¹daæ
unter Beweis stellen	udowodniæ
eine Wahl treffen	wybieraæ
in Ordnung bringen	uporz¹dkowaæ
Kritik üben an D	krytykowaæ [coœ/kogoœ]
außer Zweifel stehen	nie podlegaæ w¹tpliwoœci
Zweifel haben an D	mieæ w¹tpliwoœæ co do [czegoœ]
unter Strafe stehen	byæ karalnym
eine Chance geben/bieten	daæ szansê
Vorwürfe machen/erheben	czyniæ zarzuty
Eindruck machen auf A	zrobiæ wra¿enie na [kimœ]
unter dem Einfluss stehen	byæ pod wp³ywem
unter dem Schutz stehen	byæ pod ochron¹
eine Schwache/Faible haben für A	mieæ s³aboœæ do [czegoœ]
in Zweifel ziehen	w¹tpiæ
Untersuchungen anstellen	badaæ
jdm etw zur Kenntnis bringen	uœwiadomiæ komuœ coœ
Wert legen auf A	przywi¹zywaæ wagê do [czegoœ]
Unterricht geben/erteilen	udzielaæ lekcji
sich Sorgen machen um A	byæ zaniepokojonym o [coœ]
unter Verdacht stehen	byæ podejrzanym
ein Zeichen setzen gegen A	sprzeciwiæ siê [czemuœ]
Beachtung finden	byæ zauwa¿onym
Rücksicht nehmen auf A	uwzglêdniaæ [coœ]
im Bau sein	byæ w budowie
Vorbereitungen treffen	przygotowywaæ
einen Auftrag bekommen	otrzymaæ zlecenie
sich im Bau befinden	znajdowaæ siê w budowie
in Wut geraten	wpaœæ we wœciek³oœæ
ein Gespräch führen	prowadziæ rozmowê
einen Spaziergang machen	spacerowaæ
Anwendung finden	znaleŸæ zastosowanie
Bezug nehmen auf A	powo³ywaæ siê na [coœ]
Abschied nehmen von D	po¿egnaæ siê z [czymœ]
Anklage erheben gegen A	wnieœæ oskar¿enie przeciwko [komuœ]
Vertrauen haben zu D	mieæ zaufanie do
Angaben machen	podaæ informacje
Anstrengungen unternehmen	czyniæ wysi³ki
eine Antwort geben/erteilen	udzieliæ odpowiedzi
Anspruch erheben auf A	roœciæ sobie pretensje do [czegoœ]
einen Anfang machen	rozpocz¹æ
Verständnis haben für A	mieæ zrozumienie dla [kogoœ]
eine Vereinbarung treffen	uzgodniæ
einen Versuch unternehmen/machen	spróbowaæ
einen Wunsch haben	¿yczyæ sobie
jdm Mut machen	dodaæ komuœ odwagi
eine Erlaubnis erteilen/geben	pozwoliæ
einen Ratschlag geben/erteilen	udzieliæ rady, daæ radê
Widerstand leisten gegen A	stawiaæ opór [czemuœ]
Anerkennung finden	spotkaæ siê z uznaniem
eine Frage stellen	pytaæ, postawiæ pytanie
in Betrieb setzen	uruchomiæ (Bet...)
jdm die Schuld geben	obarczyæ kogoœ win¹
in Zussamenhang stehen mit D	mieæ zwi¹zek z [czymœ]
Vorsorge treffen	czyniæ starania
eine Nachricht bringen/geben	powiadomiæ
in Bewegung setzen	uruchomiæ (Bew..)
Einfluss ausüben auf A	wywrzeæ wp³yw na [coœ/kogoœ]
im Irrtum sein	byæ w b³êdzie
im Gegensatz stehen zu D	pozostawaæ w sprzecznoœci z [czymœ/kimœ]
eine Rolle spielen	odgrywaæ rolê
einen Auftrag geben/erteilen	zleciæ
in Gefahr bringen	naraziæ na niebezpieczeñstwo
Hilfe leisten	udzieliæ pomocy
eine Anderung vor-nehmen	przeprowadziæ zmianê
Kontakt aufnehmen	nawi¹zaæ kontakt
in Schutz nehmen	ochroniæ
in Verlegenheit/Verwirrung bringen	wprawiæ w zak³opotanie
außer Frage stehen	nie ulegaæ w¹tpliwoœci
Respekt haben vor D	mieæ respekt przed [czymœ]/powa¿anie dla [czegoœ]
eine Entscheidung treffen	zdecydowaæ
in Kontakt stehen mit	pozostawaæ w kontakcie z [kimœ]
Druck ausüben auf A	wywieraæ nacisk na [coœ/kogoœ]
zum Ausdruck bringen/kommen	wyraziæ
einen Kompromiss schließen	zawrzeæ kompromis
in Verlegenheit/Verwirrung geraten	wpaœæ w zak³opotanie
eine Korrektur vornehmen	poprawiæ, skorygowaæ
einen Anspruch erheben auf A	wysuwaæ roszczenia [w stosunku do]
Eindruck machen auf A	robiæ wra¿enie na
eine Überraschung bereiten	sprawiæ niespodziankê
etw unter Strafe stellen	karaæ coœ
Verwendung finden	znajdowaæ zastosowanie (V)
Respekt genießen	byæ respektowanym
zur Einsicht gelangen	poj¹æ coœ
zur Auswahl stehen	byæ do wyboru
Zweifel haben an D	w¹tpiæ w [coœ]
eine Freude bereiten	sprawiæ radoœæ
die Hoffnung haben	mieæ nadziejê
eine Rede halten	przemawiaæ
eine Ahnung haben	mieæ przeczucie, domyœlaæ siê
zur Verfügung stellen	postawiæ do dyspozycji
vor der Frage stehen	staæ przed problemem/pytaniem
einen Kuss geben	ca³owaæ
in Vergessenheit geraten	ulec zapomnieniu
Grüße ausrichten	przekazaæ pozdrowienia
in Armut geraten	zubo¿eæ
eine Wirkung haben/ausüben	dzia³aæ/wywieraæ dzia³anie
Angst haben vor D	baæ siê [czegoœ]
in die Frage kommen	wchodziæ w rachubê
eine Verabredung treffen	zawrzeæ porozumienie
Interesse haben an D	interesowaæ siê [czymœ]
ein Risiko ein-gehen	zaryzykowaæ
Widerspruch erheben	wysun¹æ sprzeciw
in Erwägung ziehen	rozwa¿yæ
Protokoll führen	protoko³owaæ
Anteil nehmen an D	wzi¹æ udzia³ w [czymœ]
in Erfüllung gehen	spe³niæ siê
einen Antrag stellen auf A	postawiæ wniosek o
Mut haben	mieæ odwagê
einen Entschluss fassen	zdecydowaæ siê
zur Ansicht gelangen	dojœæ do pogl¹du
sich Mühe geben	zadaæ sobie trud
zur Verfügung stehen	byæ do dyspozycji
in Gebrauch sein	byæ w u¿yciu
einen Beitrag leisten zu D	przyczyniæ siê do [czegoœ]
zum Abschluss bringen/kommen	zakoñczyæ
eine Forderung stellen/erheben	postawiæ/wysun¹æ ¿¹danie
Protest erheben	protestowaæ
